********************
*-----*------------*
*--**--****S******G*
*---**--*---*-II-*G*
***L-*A---***G**G*G*
*---**-****----*-*-*
*T***--*-----**--*-*
***-S--**--*-----*-********
*----***I---+-**-*-------C*
*-G--*----*-***--**********
*-G---+--**-*---**T*
*---LLL--S--***--*-*
*----V---*----*-D*S*
*---+----***--****-*
****SS****----*-I--*
*--------*G*-+--*--*
*-+LLLL+-*-******-**
*--LLLL--*---*-----*
*--LLLL--*---*---A-*
*T------T*--V---*-H*
********************