********************
*-----*------------*
*--**--****S******G*
*---**--*---*-II-*G*
***L-*----***G**G*G*
*---**-****----*-*-*
*T***--*-----**--*-*
***-S--**--*-----*-********
*----***I---+-**-*-------C*
*-G--*----*-***--**********
*-G---+--**-*---**T*
*---LLL--S--***--*-*
*--------*----*-D*S*
*---+----***--****-*
****SS****----*-I--*
*--------*G*-+--*--*
*-+LLLL+-*-******-**
*--LLLL--*---*-----*
*--LLLL--*---*---A-*
*T------T*------*-H*
********************